# # # # # # # # # # # #
# t # # # # # # . . i #
# . # # . . . . . # . #
# . # # . # # # # # . #
# . # # . # . . . . . #
# . . . . # t # # # # #
# # . # . # . . . . . #
# # . # . # # # # # . #
# . . # t . . # t # # #
# . # # # # . # . # . #
# . . # # # # # . . . #
# t . . . . . . . # . #
# # # # # # # # # # f #