# # # # # # # # # # # # # # # # # # # # 
f . . # i . . . . . . . . . . . . . . #
# # . # # # # # # # # # # # # # # # . #
# . . # . . . # . . . # . . . # . . . #
# . # # . # . . . # . . . # . . . # . #
# . # t . # # # # # # # # # # # # # . #
# . # # . . . . . . . . . . . . t # . #
# . t # . # # . # # # # # . # # # # . #
# . # # t # . . . . . . . . . . . # . #
# . # # # # . # # # # . # # # # . # . #
# . # t . # . # t . . . . . t # . # . #
# . # # . # t # . # # # # # . # . # . #
# . . # . # # # t . . . . . t # . # . #
# # . # . # t # # # # # # # # # . # . #
# . . # . . . . . . . . . . . . . . . #
# . # # # # # # # # # # # # # # # # . #
# . . # . . . # . . . # . . . # . . . #
# # . . . # . . . # . . . # . . . # . #
# # # # # # # # # # # # # # # # # # . #
# . . . . . . . . . . . . . . . . . . #
# # # # # # # # # # # # # # # # # # # #