# # # # # # # # # # # # # # # # # # # # 
# . . . . . . . . . . . . . . . . . . #
# . # # # # # . # # # # . # # # # # . #
# . # t . . . . # t . . . . . . . # . #
# . # # # # # . # # # # # # # # . # . #
# . . . . . # . . . . . . . t # t # t #
# . # # # . # # # # # # . # # # # # # #
# . # t # . . . . . . # . # . . . # . f
# . # . # # # # # # . # . # . # . . . #
# . # . # t . . . # t # t # . # # # # #
# . . . # # # # . # # # # # . . . # t #
# . # . . . . . . # . . . # # # . # . #
# . # . # # # # # # . # . . . . . # . #
# . # . . . t # t . . # # # # # # # . #
# . # . # # # # # . # # . . t # . . . #
# . # . . . . t # . . # . # # # . # . #
# . # . # # # # # # . # . # t . . # . #
# . # . . . . . . . . # . # # # # # . #
# . # # # # # # # # # # . # # # # # . #
# i . . . . . . . . . . . . . . . . . #
# # # # # # # # # # # # # # # # # # # #